████████
█░░█░░░█
██░░░░░█
█░░░██!█
█░░░░░░█
████████
