^^^^^^^^
^00^000^
^^00000^
^000^^!^
^000000^
^^^^^^^^
